SwwwwwwwwwwwwdwwwwS
S.................S
S.................S
S......p..........S
S.................S
S............k....S
S.................S
S.................S
wwwwwwwwwwwwwwwwww
