swwwwwwwwwwwwcwwwws
s.................s
s.................s
s......tttttttt...s
s......tmmmmmmt...s
s......t......t...s
s.............TTTTs
s........k........s
s..z..............s
s..s..............s
s.................s
s.........p.......s
sssssssssssssssssss
