swwwwwwwwwwwwdwwwwS
s.................S
s.................S
s......p..........S
s.................S
s............k....S
..................S
s.................S
jwwwwwwwwwwwwwwwwwJ

qe