swwwwwwwwwwwwdwwwws
s.................s
s.................s
s......p..........s
s.................s
s............k....s
s.................s
s.................s
sssssssssssssssssss
