                  ......
                  ......
                  ......
                  ......
                  ......
                  ......
                  ......
                  ......
                  ......
                  ......
                  ......
                  ......
                  ......
..........        ......      ......    ....
..........        ......      ......    ....
....  ......................................
....  ......................................
..              ..      ..    ......    ..
..              ..      ..    ......    ..
..  ......    ..............    ..      ..
..  ......    ..............    ..      ..
..........  ..................  ..  ........
..........  ..................  ..  ........
..  ......  ..................  ..  ........
..  ......  ..................  ..  ........
..            ..............    ....      ..
..            ..............    ....      ..
..  ......  ....    ..    ....  ..  ........
..  ......  ....    ..    ....  ..  ........
..........        ......        ..  ........
..........        ......        ..  ........
..  ......  ............  ....  ..        ..
..  ......  ....  ............  ..        ..
..          ....    ..    ....  ..  ........
..                  ..          ..  ........
..  ......  ......  ..  ......  ..  ........
..  ......  ......  ..  ......  ..  ........
............................................
............................................
..  ......  ......  ..  ......      ........
..  ......  ......  ..  ......      ........
..                  ..                    ..
..                  ..                    ..
............        ..        ..............
............        ..        ..............
........  ..      ......      ..  ..      ..
........  ..      ......      ..  ..      ..
........  ......................  ......  ..
........  ......................  ......  ..
........          ......          ..........
........          ......          ..........
                    ..
                    ..
                    ..
                    ..
                    ..
                    ..
                    ..
                    ..
                 .........
                 .........
                 .........
                 .........