swwwwwwwwwwwwdwwwwS
s.................S
s.................S
s......p..........S
s.................S
s............k....S
s.................S
s....c............S
jwwwwwwwwwwwwwwwwwJ